----------------------------------------------------------------------------cc---------------------------c-----------------------------------------------------
-----------------------------------------------------------------------------c---------------------------------------------------------------------------------
-----------------------------------------------------------------------------c---------------------------------------------------------------------------------
---------------------------------------------------------------------------------------------------------------------------------------------------------------
-------------------------------------------------------------------------------cc------------------------------------------------------------------------------
-------------------------------------------------------------c-------------------------------------------------------------------------------------------------
---------------------------------------------------------------------------------------------------------------------------------------------------------------
---------------------------------------------------------------------------------------------------------------------------------------------------------------
---------------------------------------------------------------------------------------------------------------------------------------------------------------
-------------------------------------------------------------------------------------------------------------------------------#####################-----------
----------------------------c--------------------------------------------------------------------------------------------------#-------------------##----------
----------------------------cc-------------------------------------------------------------------------------------------------#--################--#----------
------------------------------------------------------------------------------------------------------------------------------##-##--------------##-#----------
------------------------------------------------------------------------------------------------------------------------------#--#----------------#-#----------
-----------------------##################-------------------------------------------------------------------------------------#--#-#############--#-##---------
------------------######----------------##########----------------------------------------------------------------------------#--#-#--xx-------#--#--#---------
------------------#------------------------------##--------------------------------------------------------------------------##--#-#-xxxx--yyy-#--#--#---------
----------------###-------------------------------#--------------------------------------------------------------------------#--##-#-xxxxxxyyy-#--#--#---------
---##############---------------------------------###-----------------------------------------------------------------------##--#--#--xxxxxyyy-#--#--#---------
####------------------------------------------------#-----------------------------------------------------------------------#--##-##----xxyyy--#--#--#---------
#---------------------------------------------------#-----------------------------------------------------------------------#--#--#----##zzyyy-#--#--#---------
----------------------------------------------------##########--------------------------------------------------------------#--#--#x---##yyyyyy#--#--#---------
-------------------------------------------------------------###########----------------------------------------------------#--#--#--###-yyyyyy#--#--#---------
-----------------------------------------------------------------------#----------------------------------------------------#--#--#--#--yyy-yy-#--#--#---------
-----------------------------------------------------------------------#----------------------------------------------------#--#--#--###-yy-####--#--#---------
-----------------------------------------------------------------------#############----------------------------------------#--#--##---#-y-##-----#--#---------
----------------------------------------c------------------------------------------##########################---------------#--#---###-#####----###--#---------
-----------------------------------------cc-----------------------------------------------------------------##--------------#--###---##------####----#---------
----------------c------------------------cc--------------------------c---------------------------------------##-------------##---###--#------#-----###---------
---------------------------------------------------------------------ccc--------------------------------------#--------------###---##-########-#####-----------
--------------------------------------------------------------------------------------------------------------##---------------###--##--------##---------------
----c----------------------------------------------------------------------------------------------------------#-----------------##--#-------##---###----------
---------------------------------------------------------------------------------------------------------------##############-----##-#########--###-#----------
----------------------------------------------------------------------------------------------------------------------------#------##----------##---#----------
----------------------------------------------------------------------------------------------------------------------------#-------#----------#----#----------
--------------------------------------------------------------------------c-------------------------------------------------###-----############----#----------
-------------------------------------------------------------------------cc---------------------------------------------------#---------------------#----------
------------------------------------------------------------------------ccc---------------------------------------------------#---------------------#----------
------------------------------------------------------------------------cccc--------------------------------------------------#---------------------#----------
------------------------------------------------c------------------------------------------------------------------------c----#---------------------#----------
--------------------------------------------------------------c---------------------------------------------------------cc----#######################----------
